NO ./assets/vheran/42/nblack.xpm
SO ./assets/vheran/42/nred.xpm
WE ./assets/vheran/42/ngreen.xpm
EA ./assets/vheran/42/nblue.xpm

F 220,100,0
C 225,30,0

111111111
100000001
100001001
110000001
1N00P0001
110000001
100001001
100000001
111111111