NO ./assets/vheran/42/black.xpm
SO ./assets/vheran/42/altcores.xpm
WE ./assets/vheran/42/altpros.xpm
EA ./assets/vheran/42/altthreads.xpm

F 56,62,66
C 47,79,79


11111
11O11
1O0O1   N
11O11
11111