NO ./assets/vheran/42/black.xpm
SO ./assets/vheran/42/altcores.xpm
WE ./assets/vheran/42/altpros.xpm
EA ./assets/vheran/42/altthreads.xpm

F 56,62,66
C 47,79,79

        1111111111111111111111111
        1000000000110000000000001
        1011000001110000000000001
        1001000000000000000000001
111111111011000001110000000000001
100000000011000001110111111111111
11110111111111011100000010001
11110111111111011101010010001
11000000000001011100000010001
1001010111000000110001110001
1001010001000000011001100011
1001110111000000011100010001
10000101000000000000000000011
10000101110000001101010010001
1100000000011011111011110N0111
1111011111110101 101111010001
11111111 1111111 111111111111