NO ./assets/cardinal/north.xpm
SO ./assets/cardinal/south.xpm
WE ./assets/cardinal/west.xpm
EA ./assets/cardinal/east.xpm

F 220,100,0
C 225,30,0

111111111
110000101
100000001
100000001
1000N0001
100000001
111000101
100000101
111111111