NO ./assets/vheran/42/black.xpm
SO ./assets/vheran/42/altcores.xpm
WE ./assets/vheran/42/altpros.xpm
EA ./assets/vheran/42/altthreads.xpm

F 196,88,36
C 135,206,235

111111111111111
100000000000001
100000000000001
10000DDDD000001
100000000000001
100100000000001
100O00000000001
1001000W0001001
100D00000000001
100100000000001
100000000000001
1000001O1000001
100000000000001
100000000000001
111111111111111