NO ./assets/cardinal/north.xpm
SO ./assets/cardinal/south.xpm
WE ./assets/cardinal/west.xpm
EA ./assets/cardinal/east.xpm

F 196,88,36
C 135,206,235

111111111111111
100000000000001
100000000000001
100000000000001
100000000000001
100100000000001
100000000000001
1001000E0001001
100000000000001
100100000000001
100000000000001
100000101000001
100000000000001
100000000000001
111111111111111