

EA ./assets/cardinal/east.xpm     
  F   220   ,100  ,  10       

    NO   ./assets/cardinal/north.xpm 

WE       ./assets/cardinal/west.xpm
SO ./assets/cardinal/south.xpm




C 225    ,30,   15        




  1111111111111111111111111111   
     11100000000011000111100111
  111111101100000111111  1001    
        100100000001     1000111
11111  11011000001111111100000001
10001  1111111110111011111111111
11111           1100000010001 
11110111111111111101010010001
1111111111111111111111010001
                      1010001
11111111111111111111  1010001
11000001110101011111  11100011
  110111 1110101      1010N01
11111111 1111111  11111111111


