

EA ./assets/vheran/42/nblue.xpm     
  F   220   ,100  ,  10       

    NO  ./assets/vheran/42/black.xpm 

WE       ./assets/vheran/42/ngreen.xpm
SO ./assets/vheran/42/nred.xpm




C 225    ,30,   15        




  1111111111111111111111111111   
     11100000000000000111100111
  111111101100000111111  1001    
        100100000001     1000111
11111  11011000001001111100000001
10001  1111111110110011111011111
11011           1100000010001 
11010111111111111101010000001
10000000000000000000000000001
1111111111111111111111010001
                      1010001
11111111111111111111  1010001
11000001110101011111  11100011
  110111 1110101      1010N01
11111111 1111111  1111111111


